NO ./textures/Alexanderplatz_station.xpm
WE ./textures/Alexanderplatz_station.xpm
SO ./textures/Alexanderplatz_station.xpm
EA ./textures/Alexanderplatz_station.xpm
F 135,125,100
C 109,158,173

11111111111111111111
10000010000000100001
10001100000000010001
10000100000000001001
1010000000S000000001
11111111111111111111